1111111111
1000000001
1000000001
10000000Z1
1000000001
10S0000001
1000000001
1111111111

1111111111
10000A0001
100000A001
1000100001
1000100001
10S0000001
1000000001
1111111111

1111111111111111
1S01001000001001
1001001000001001
100000000100A001
1000000001A0A001
1011001000000001
1000001000000001
1000000001A0A001
100100000100A001
1001001000001001
1000001000001001
1111111111111111

111111111111111111
1S01A000A1000000B1
100100000100000001
1001A010A10A010A01
100100100100010A01
1000A0100000000001
10000010A0000000B1
111111111111111111

1111111111
1000B00B01
1000000001
100000B001
10001100B1
1000110001
10S0000001
1000000001
1000000001
1111111111

1111111111111111111111111
1000000000000111111111111
1B00000AB0000111000011111
10000110000000000A0001111
100001100000000000B001111
1000011000B0A000000011111
1000B0000A000B00000011111
1000000001000000000011111
100000001111000000000A111
10011000010000000000B0011
100110000B000001110000001
1000000000000001110000001
1000000000000000000000001
100011111100000000000B001
1000000000000000000000001
10S0000000000000000000001
1111111111111111111111111

1111111111111111111
1000000001000000001
100000000100C000001
10S0100000000000C01
1000100000000000001
1000000000000010001
100000000C000010001
1111111111111111111

1111111111111111111111111
10000000000000000000B0001
10S0011AB00B0001000011001
10000110000000010A0001001
100001100000000000BC00001
1000011000B0A000000000001
100001100A000B000C0010001
1000011111100000000010001
100001111110000000000A001
10000000010000000000B0001
100BB0000B000001110000001
10000000000000011100C0001
10000000000C0000000000001
1111111111111111111111111

1111111111
1000D00D01
1000000001
100000D001
10000000D1
1001100001
10001000D1
10S0000001
1000000001
1111111111